ABAABAABAABA
AABBAAAABBAA
ABAABAABAABA
BAABAABAABAA
ABAABAABAABA
ABAABAABAABA
AABBAAAABBAA
ABAABAABAABA
